0000000000000000000000000000000000000000000000000000000000000000000000000000000000000000000000000000000000000000000000000000000000000000000000000000000000000000000000000000000000000020
0000000000000000000000000000000000000000000000000000000077700000000000000000000000000000000000000000000000000000000000000000000000000000000000000000000000000000000000000000000000000020
000000000000000000000000000000000000000030000000000000007G700000000000000000000000000000000000000000000000000000000000000000000000000000000000000000000000000000000000000000000000000020
0000000000000000000000000000000000000711110001033433330111110073700007000000000000000000000000000000000000000000000000000000000000000000000000000000000000000000000000000000000000000020
0000000000000000000000000000000000007122220002000000000000001111110037300007000000000000000000000000000000000000000000000000000000000000000000000000000000000000000000000000000000000020
0000000000000000000000000000000000071222220002000000000000000000001111110070700000000000000000000000000000000000000000000000000000000000000000000000000000000000000000000000000000000020
0000000000000000000000000000000000712222220002000000000000000000000000001114110000000000000000000000000000007000000000000000000000000000000000000000000000000000000000000000000000000020
0000000000000000000000000000000007122222220002000000000000000000000000000027201170000007000000000000000000074700000000000000000000000000000000000000000000000000000000000000000000000020
0000000000700000000000000000000071222222220802000000000000000000000000000027200017000003000000000000000000111110000000000000000000000000000000000000000000000000000000000000000000000020
0000000000100000000000777770000712222222220702000003333000000000000000000027200001700011100000000000000003000000000000000000000000000000000000000777770000077777700000000000000000000020
000770C00120000009000000000000712222222222070000060000000700000600000600000700000000012227000060070000003000000000060060006000600000000090777000000000000000000000000600007777770900E020
0407700012210000000500333330071222222222220300000000000003000000000000000007000000001222271000007000000300000000000000000000000005330333007770000333330000033333300000000000000000000020
1111111122221111111111111111112222222222221111111111111111111111111111111111111111112222212111111111111111111111111111111111111111111111111111111111111111000000001111111111111111111120
2222222222222222222222222222222222222222222222222222222222222222222222222222222222222222222222222222222222222222222222222222222222222222222222222222222222000000002222222222222222222220
2222222222222222222222222222222222222222222222222222222222222222222222222222222222222222222222222222222222222222222222222222222222222222222222222222222222000000002222222222222222222220
2222222222222222222222222222222222222222222222222222222222222222222222222222222222222222222222222222222222222222222222222222222222222222222222222222222222000000002222222222222222222220
