00000000000000000000000000000000000000000000000000000000000000000000000000000000000000000000000000000000000000000000000000000000000000000000000000000000000000000000000000000000000000200
00000000000000000000000000000000000000000000000000000000000000000000000000000000000000000000000000000000000000000000000000000000000000000000000000000000000000000000000000000000000000200
00000000000000000000000000000000000000000000000000000000000000000000000000000000000000000000000000000000000000000000000000000000000000000000000000000000000000000000000000000000000000200
00000000000000000000000000000000000000000000000000000000000000000000000000000000000000000000000000000000000000000000000000000000000000000000000000000000000000000000000000000000000000200
00000000000000000000000000000000000000000000000000000070000000000000000000000000000000000000000000000000000000000000000000000000000000000000000000000000000000000000000000000000000000200
00000000000000000000000000000000000000000000000000000737007770000000000000000000000000000000000000000000000000000000000000000000000000000000000000000000000000000000000000000000000000200
00000000000000000000777000000000000000000000007000011111173337007000000000000000000000770000000000000000000000000000000000000000000000000000777000000000000000000000000000000000000000200
00000000000000000007333700000000000000000000074700100000011111073703300000000000000007347000000000000000G00000000000000000000000000000000000373000000000000000000000000000000000000000200
00000000000000000011111107000000000000000000011111000000000000111111117000000000000011111130130130130130107000000000000000000000000000000001111100000000000000000000000000000000000000200
00000000007770000300000007000000000007770000120000000000000000000000007000000000000300000000000000000000007000000000007700770077000000000030000000000000000000000000000000000000000000200
7070C0000000000030000600007000009000006000012280060070060070060070000070097700600030000777000060006000600070000900000700707077070000900003000600077000000000000000000000000006007700E0200
73700007003330040000000000700300000000000012220000003000003000007000007000770000030050077700000000000000007000003300077770700007000000003070000077770000000033333333333330000000770000200
11111111000001111111111111111111111111111122221111111111111111111111111111111111111111111111111111111111111111111111170071703307111111111111111111111111111000000000000000111111111111200
22222222000002222222222222222222222222222222222222222222222222222222222222222222222222222222222222222222222222222222211111111111222222222222222222222222222000000000000000222222222222200